戶	户
癒	瘉
嘆	歎
衛	衞
褒	襃
沉	沈
說	説
脫	脱
蛻	蜕
閱	閲
悅	悦
銳	鋭
兌	兑
薦	荐
稅	税
溫	温
蘊	藴
蔥	葱
臺	台
勳	勛
敘	敍
臥	卧
爲	為
僞	偽
嬀	媯
潙	溈
棱	稜
啓	啟
鉤	鈎
贗	贋
睪	睾
醞	醖
涌	湧
踊	踴
竈	灶
衆	眾
覈	核
棱	稜